MISSIONTYPE 0
SIZE 11/30
LIMIT 0/35
COLOR LIMIT 4
STARS 15000/75000/90000
6 6 3 3 3 3 6 6 1 1 1
6 6 3 3 6 6 1 1 6 1 0
0 5 5 0 0 0 0 0 0 0 0
0 6 5 0 0 0 0 0 0 0 0
0 0 5 6 6 6 6 6 6 6 6
0 0 6 6 6 6 6 6 6 6 0
0 0 0 0 0 0 0 0 6 6 0
0 0 0 0 0 0 0 6 6 0 0
6 6 6 6 6 6 6 6 6 0 0
6 6 6 6 6 6 6 6 0 0 0
0 5 5 0 0 0 0 0 0 0 0
0 5 6 0 0 0 0 0 0 0 0
0 0 5 6 6 6 6 6 6 6 6
0 0 5 6 6 6 6 6 6 6 0
0 0 0 0 0 0 0 0 1 1 0
0 0 0 0 0 0 0 6 1 0 0
6 6 6 6 6 6 6 6 1 0 0
0 6 6 6 6 6 6 6 0 0 0
0 0 0 0 0 0 0 0 0 0 0
0 0 0 0 0 0 0 0 0 0 0
0 0 0 0 0 0 0 0 0 0 0
0 0 0 0 0 0 0 0 0 0 0
0 0 0 0 0 0 0 0 0 0 0
0 0 0 0 0 0 0 0 0 0 0
0 0 0 0 0 0 0 0 0 0 0
0 0 0 0 0 0 0 0 0 0 0
0 0 0 0 0 0 0 0 0 0 0
0 0 0 0 0 0 0 0 0 0 0
0 0 0 0 0 0 0 0 0 0 0
0 0 0 0 0 0 0 0 0 0 0