MISSIONTYPE 2
SIZE 11/30
LIMIT 0/29
COLOR LIMIT 4
STARS 3500/4500/6800
6 6 5 5 6 6 6 1 1 6 6
0 5 8 5 0 0 1 8 1 0 0
0 0 5 5 0 0 0 1 1 0 0
0 3 3 0 2 2 0 3 3 0 0
0 3 8 3 2 8 2 3 8 3 0
0 3 3 0 2 2 0 3 3 0 0
0 0 1 1 0 0 0 5 5 0 0
0 1 8 1 3 3 5 8 5 0 0
0 0 1 1 3 8 3 5 5 0 0
0 2 2 0 3 3 0 2 2 0 0
0 2 8 2 0 0 0 2 8 2 0
0 2 2 0 3 3 0 2 2 0 0
0 0 5 5 3 8 3 1 1 0 0
0 5 8 5 3 3 1 8 1 0 0
0 0 5 5 0 0 0 1 1 0 0
0 1 1 0 2 2 0 5 5 0 0
0 1 8 1 2 8 2 5 8 5 0
0 1 1 0 2 2 0 5 5 0 0
0 0 0 0 4 12 12 2 0 0 0
0 0 0 4 12 10 12 2 0 0 0
0 0 0 0 4 12 12 2 0 0 0
0 0 0 0 4 2 2 0 0 0 0
0 0 0 0 0 0 0 0 0 0 0
0 0 0 0 0 0 0 0 0 0 0
0 0 0 0 0 0 0 0 0 0 0
0 0 0 0 0 0 0 0 0 0 0
0 0 0 0 0 0 0 0 0 0 0
0 0 0 0 0 0 0 0 0 0 0
0 0 0 0 0 0 0 0 0 0 0
0 0 0 0 0 0 0 0 0 0 0