MISSIONTYPE 1
SIZE 11/30
LIMIT 0/22
COLOR LIMIT 4
STARS 15000/25000/50000
0 2 2 0 1 1 0 3 3 0 0
2 8 2 1 8 1 3 8 3 0 0
0 2 2 0 1 1 0 3 3 0 0
0 0 3 3 0 5 5 0 1 1 0
0 0 3 8 3 5 8 5 1 8 1
0 0 3 3 0 5 5 0 1 1 0
0 5 5 0 2 2 0 3 3 0 0
5 8 5 2 8 2 3 8 3 0 0
0 5 5 0 2 2 0 3 3 0 0
0 0 3 3 0 5 5 0 1 1 0
0 0 3 8 3 5 8 5 1 8 1
0 0 3 3 0 5 5 0 1 1 0
0 5 5 0 1 1 0 2 2 0 0
5 8 5 1 8 1 2 8 2 0 0
0 5 5 0 1 1 0 2 2 0 0
0 0 0 0 0 0 0 0 0 0 0
0 0 0 0 0 0 0 0 0 0 0
0 0 0 0 0 0 0 0 0 0 0
0 0 0 0 0 0 0 0 0 0 0
0 0 0 0 0 0 0 0 0 0 0
0 0 0 0 0 0 0 0 0 0 0
0 0 0 0 0 0 0 0 0 0 0
0 0 0 0 0 0 0 0 0 0 0
0 0 0 0 0 0 0 0 0 0 0
0 0 0 0 0 0 0 0 0 0 0
0 0 0 0 0 0 0 0 0 0 0
0 0 0 0 0 0 0 0 0 0 0
0 0 0 0 0 0 0 0 0 0 0
0 0 0 0 0 0 0 0 0 0 0
0 0 0 0 0 0 0 0 0 0 0