MISSIONTYPE 0
SIZE 11/30
LIMIT 0/29
COLOR LIMIT 4
STARS 3500/4500/6800
6 6 5 5 6 6 6 1 1 6 6
0 5 0 5 0 0 1 0 1 0 0
0 0 5 5 0 0 0 1 1 0 0
0 3 3 0 2 2 0 3 3 0 0
0 3 0 3 2 0 2 3 0 3 0
0 3 3 0 2 2 0 3 3 0 0
0 0 1 1 0 0 0 5 5 0 0
0 1 0 1 3 3 5 0 5 0 0
0 0 1 1 3 0 3 5 5 0 0
0 2 2 0 3 3 0 2 2 0 0
0 2 0 2 0 0 0 2 0 2 0
0 2 2 0 3 3 0 2 2 0 0
0 0 5 5 3 0 3 1 1 0 0
0 5 0 5 3 3 1 0 1 0 0
0 0 5 5 0 0 0 1 1 0 0
0 1 1 0 2 2 0 5 5 0 0
0 1 0 1 2 0 2 5 0 5 0
0 1 1 0 2 2 0 5 5 0 0
0 0 0 0 0 0 0 0 0 0 0
0 0 0 0 0 0 0 0 0 0 0
0 0 0 0 0 0 0 0 0 0 0
0 0 0 0 0 0 0 0 0 0 0
0 0 0 0 0 0 0 0 0 0 0
0 0 0 0 0 0 0 0 0 0 0
0 0 0 0 0 0 0 0 0 0 0
0 0 0 0 0 0 0 0 0 0 0
0 0 0 0 0 0 0 0 0 0 0
0 0 0 0 0 0 0 0 0 0 0
0 0 0 0 0 0 0 0 0 0 0
0 0 0 0 0 0 0 0 0 0 0