MISSIONTYPE 3
SIZE 11/30
LIMIT 0/35
COLOR LIMIT 3
STARS 15000/50000/70000
6 6 5 5 5 5 5 1 1 1 6
0 1 5 0 5 6 0 5 1 0 0
0 0 3 0 0 3 0 0 5 0 0
0 1 1 0 1 3 0 5 5 0 0
0 1 9 6 0 1 0 3 9 3 0
5 12 12 6 6 6 6 12 12 6 0
5 5 5 5 6 5 5 5 3 3 6
0 6 6 0 5 5 0 6 6 0 0
0 0 6 0 0 5 0 0 6 0 0
0 0 0 0 3 3 0 0 0 0 0
0 0 0 0 3 9 6 0 0 0 0
0 0 0 3 12 12 6 0 0 0 0
0 0 0 6 6 6 6 6 0 0 0
0 0 0 0 6 6 0 0 0 0 0
0 0 0 0 0 6 0 0 0 0 0
0 0 0 0 0 0 0 0 0 0 0
0 0 0 0 0 0 0 0 0 0 0
0 0 0 0 0 0 0 0 0 0 0
0 0 0 0 0 0 0 0 0 0 0
0 0 0 0 0 0 0 0 0 0 0
0 0 0 0 0 0 0 0 0 0 0
0 0 0 0 0 0 0 0 0 0 0
0 0 0 0 0 0 0 0 0 0 0
0 0 0 0 0 0 0 0 0 0 0
0 0 0 0 0 0 0 0 0 0 0
0 0 0 0 0 0 0 0 0 0 0
0 0 0 0 0 0 0 0 0 0 0
0 0 0 0 0 0 0 0 0 0 0
0 0 0 0 0 0 0 0 0 0 0
0 0 0 0 0 0 0 0 0 0 0