MISSIONTYPE 3
SIZE 11/30
LIMIT 0/40
COLOR LIMIT 4
STARS 3200/5600/12000
0 0 0 0 0 6 0 0 0 0 0
0 0 0 0 12 12 0 0 0 0 0
0 0 0 0 12 11 12 0 0 0 0
0 0 0 0 12 12 0 6 6 6 0
0 12 12 0 0 0 0 6 12 12 6
12 11 12 0 0 0 6 12 11 12 6
0 12 12 0 0 0 0 6 12 12 6
0 0 0 6 6 6 0 6 6 6 0
0 0 0 6 12 12 6 0 0 0 0
0 0 6 12 11 12 6 0 0 0 0
0 0 0 6 12 12 6 0 0 0 0
0 0 0 6 6 6 0 0 0 0 0
0 0 0 0 0 0 0 0 0 0 0
0 0 0 0 0 0 0 0 0 0 0
0 0 0 0 0 0 0 0 0 0 0
0 0 0 0 0 0 0 0 0 0 0
0 0 0 0 0 0 0 0 0 0 0
0 0 0 0 0 0 0 0 0 0 0
0 0 0 0 0 0 0 0 0 0 0
0 0 0 0 0 0 0 0 0 0 0
0 0 0 0 0 0 0 0 0 0 0
0 0 0 0 0 0 0 0 0 0 0
0 0 0 0 0 0 0 0 0 0 0
0 0 0 0 0 0 0 0 0 0 0
0 0 0 0 0 0 0 0 0 0 0
0 0 0 0 0 0 0 0 0 0 0
0 0 0 0 0 0 0 0 0 0 0
0 0 0 0 0 0 0 0 0 0 0
0 0 0 0 0 0 0 0 0 0 0
0 0 0 0 0 0 0 0 0 0 0