MISSIONTYPE 1
SIZE 11/30
LIMIT 0/45
COLOR LIMIT 3
STARS 5000/100000/120000
6 6 6 6 6 6 6 6 6 6 6
6 6 6 6 6 6 6 6 6 6 0
6 6 0 6 6 0 6 6 0 6 6
6 0 0 6 0 0 6 0 0 6 0
6 6 6 6 6 6 6 6 6 6 6
6 6 6 0 6 6 0 6 6 6 0
0 6 6 0 0 6 0 0 6 6 0
6 6 6 6 6 6 6 6 6 6 0
6 6 0 6 6 0 6 6 0 6 6
6 0 0 6 0 0 6 0 0 6 0
6 6 6 6 6 6 6 6 6 6 6
6 6 6 0 6 6 0 6 6 6 6
6 6 6 0 0 6 0 0 6 6 6
6 6 6 6 6 6 6 6 6 6 0
0 0 0 0 0 0 0 0 0 0 0
0 0 0 0 0 0 0 0 0 0 0
0 0 0 0 0 0 0 0 0 0 0
0 0 0 0 0 0 0 0 0 0 0
0 0 0 0 0 0 0 0 0 0 0
0 0 0 0 0 0 0 0 0 0 0
0 0 0 0 0 0 0 0 0 0 0
0 0 0 0 0 0 0 0 0 0 0
0 0 0 0 0 0 0 0 0 0 0
0 0 0 0 0 0 0 0 0 0 0
0 0 0 0 0 0 0 0 0 0 0
0 0 0 0 0 0 0 0 0 0 0
0 0 0 0 0 0 0 0 0 0 0
0 0 0 0 0 0 0 0 0 0 0
0 0 0 0 0 0 0 0 0 0 0
0 0 0 0 0 0 0 0 0 0 0