MISSIONTYPE 2
SIZE 11/30
LIMIT 0/29
COLOR LIMIT 5
STARS 20000/55000/110000
0 0 6 6 6 6 6 6 6 0 0
0 0 6 6 6 6 6 6 0 0 0
0 0 0 6 0 0 0 6 0 0 0
0 0 0 6 12 12 6 0 0 0 0
0 0 0 6 12 10 12 6 0 0 0
0 0 0 6 12 12 6 0 0 0 0
6 0 6 0 6 0 6 0 6 0 6
6 0 6 6 6 6 6 6 0 6 0
0 6 6 6 6 6 6 6 6 6 0
0 0 9 0 6 6 0 9 0 0 0
6 0 12 12 0 6 0 12 12 0 6
6 6 6 6 6 6 6 6 6 6 0
0 0 0 6 0 6 0 6 0 0 0
6 6 6 6 6 6 6 6 6 6 0
0 8 0 0 6 0 6 0 0 8 0
6 6 6 6 6 6 6 6 6 6 0
6 0 6 0 6 0 6 0 6 0 6
6 6 0 0 6 6 0 0 6 6 0
6 0 6 0 6 0 6 0 6 0 6
0 0 0 0 0 0 0 0 0 0 0
0 0 0 0 0 0 0 0 0 0 0
0 0 0 0 0 0 0 0 0 0 0
0 0 0 0 0 0 0 0 0 0 0
0 0 0 0 0 0 0 0 0 0 0
0 0 0 0 0 0 0 0 0 0 0
0 0 0 0 0 0 0 0 0 0 0
0 0 0 0 0 0 0 0 0 0 0
0 0 0 0 0 0 0 0 0 0 0
0 0 0 0 0 0 0 0 0 0 0
0 0 0 0 0 0 0 0 0 0 0