MISSIONTYPE 0
SIZE 11/30
LIMIT 0/28
COLOR LIMIT 4
STARS 10000/20000/30000
6 6 6 6 6 6 6 6 6 6 6
6 6 6 6 6 6 6 6 6 6 0
0 6 6 6 6 6 6 6 6 6 0
0 6 6 6 6 6 6 6 6 0 0
0 0 6 6 6,True 6,True 6,True 6 6 0 0
0 6 6 6 6 6 6 6 6 0 0
6 6 6 6 6 6 6 6 6 6 6
0 6 6 6,True 6,True 6,True 6,True 6 6 0 0
0 0 6 0 6 0 6 0 6 0 0
0 6 6 0 0 0 0 6 6 0 0
0 6,True 6,True 0 0 0 0 0 6,True 6,True 0
0 0 0 0 0 0 0 0 0 0 0
0 0 0 0 0 0 0 0 0 0 0
0 0 0 0 0 0 0 0 0 0 0
0 0 0 0 0 0 0 0 0 0 0
0 0 0 0 0 0 0 0 0 0 0
0 0 0 0 0 0 0 0 0 0 0
0 0 0 0 0 0 0 0 0 0 0
0 0 0 0 0 0 0 0 0 0 0
0 0 0 0 0 0 0 0 0 0 0
0 0 0 0 0 0 0 0 0 0 0
0 0 0 0 0 0 0 0 0 0 0
0 0 0 0 0 0 0 0 0 0 0
0 0 0 0 0 0 0 0 0 0 0
0 0 0 0 0 0 0 0 0 0 0
0 0 0 0 0 0 0 0 0 0 0
0 0 0 0 0 0 0 0 0 0 0
0 0 0 0 0 0 0 0 0 0 0
0 0 0 0 0 0 0 0 0 0 0
0 0 0 0 0 0 0 0 0 0 0