MISSIONTYPE 0
SIZE 11/30
LIMIT 0/29
COLOR LIMIT 5
STARS 2500/3900/5000
6 6 6 6 6 6 6 6 6 6 6
6 6 0 0 0 0 0 0 6 6 0
6 6 0 0 0 0 0 0 6 6 0
6 6 6 6 6 6 6 6 6 6 0
0 6 6 6 6 6 6 6 6 6 0
0 6 6 6 6 6 6 6 6 0 0
0 0 6 6 6 6 6 6 6 0 0
0 0 6 6 6 6 6 6 0 0 0
0 0 0 6 6 6 6 6 0 0 0
0 0 0 6 6 6 6 0 0 0 0
0 0 0 0 6 6 6 0 0 0 0
0 0 0 0 6 6 0 0 0 0 0
0 6 6 6 6 6 6 6 6 6 0
0 6 6 6 6 6 6 6 6 0 0
0 0 6 6 0 0 0 6 6 0 0
0 0 6 6 0 0 6 6 0 0 0
0 0 0 6 6 0 6 6 0 0 0
0 0 0 6 6 6 6 0 0 0 0
0 0 0 0 6 6 6 0 0 0 0
0 0 0 0 6 6 0 0 0 0 0
6 6 6 6 6 6 6 6 6 6 6
6 6 0 0 0 0 0 0 6 6 0
0 6 6 6 6 6 6 6 6 6 0
0 0 6 6 6 6 6 6 0 0 0
0 0 0 6 6 6 6 6 0 0 0
0 0 0 6 6 6 6 0 0 0 0
6 0 0 0 6 6 6 0 0 0 6
6 0 0 0 6 6 0 0 0 6 0
0 6 6 6 6 6 6 6 6 6 0
0 0 0 0 0 0 0 0 0 0 0