MISSIONTYPE 0
SIZE 11/30
LIMIT 0/40
COLOR LIMIT 4
STARS 12000/27000/60000
FREE BOOST SCORE 27000
6 1 1 1 6 3 3 3 2 2 5
0 6 1 5 1 1 1 3 3 0 0
0 5 1 2 1 2 3 2 3 2 0
5 2 0 0 1 1 0 0 3 0 0
0 2 5 0 0 3 0 0 1 3 0
0 0 2 0 3 1 0 5 0 0 0
0 0 0 2 3 3 1 3 0 0 0
0 1 5 3 0 0 3 2 5 0 0
0 2 0 1 0 2 0 1 0 3 0
0 3 3 1 1 2 2 5 5 0 0
0 3 5 1 0 0 0 2 3 5 0
0 5 5 0 0 0 0 3 3 0 0
0 0 0 0 0 0 0 0 0 0 0
0 0 0 0 0 0 0 0 0 0 0
0 0 0 0 0 0 0 0 0 0 0
0 0 0 0 0 0 0 0 0 0 0
0 0 0 0 0 0 0 0 0 0 0
0 0 0 0 0 0 0 0 0 0 0
0 0 0 0 0 0 0 0 0 0 0
0 0 0 0 0 0 0 0 0 0 0
0 0 0 0 0 0 0 0 0 0 0
0 0 0 0 0 0 0 0 0 0 0
0 0 0 0 0 0 0 0 0 0 0
0 0 0 0 0 0 0 0 0 0 0
0 0 0 0 0 0 0 0 0 0 0
0 0 0 0 0 0 0 0 0 0 0
0 0 0 0 0 0 0 0 0 0 0
0 0 0 0 0 0 0 0 0 0 0
0 0 0 0 0 0 0 0 0 0 0
0 0 0 0 0 0 0 0 0 0 0
