MISSIONTYPE 0
SIZE 11/30
LIMIT 0/34
COLOR LIMIT 3
STARS 5000/15000/40000
FREE BOOST SCORE 15000
6 6 6 6 6 6 6 6 6 6 6
0 0 6 0 0 6 0 0 6 0 0
6 0 6 6 0 6 6 0 6 6 0
6 6 0 6 6 0 6 6 0 6 0
0 6 0 0 6 0 0 6 0 0 6
6 6 0 6 6 0 6 6 0 6 0
6 0 6 6 0 6 6 0 6 6 0
0 0 6 0 0 6 0 0 6 0 0
0 0 6 6 0 6 6 0 6 6 0
0 6 0 6 6 0 6 6 0 6 0
0 6 0 0 6 0 0 6 0 0 6
0 0 0 0 0 0 0 0 0 0 0
0 0 0 0 0 0 0 0 0 0 0
0 0 0 0 0 0 0 0 0 0 0
0 0 0 0 0 0 0 0 0 0 0
0 0 0 0 0 0 0 0 0 0 0
0 0 0 0 0 0 0 0 0 0 0
0 0 0 0 0 0 0 0 0 0 0
0 0 0 0 0 0 0 0 0 0 0
0 0 0 0 0 0 0 0 0 0 0
0 0 0 0 0 0 0 0 0 0 0
0 0 0 0 0 0 0 0 0 0 0
0 0 0 0 0 0 0 0 0 0 0
0 0 0 0 0 0 0 0 0 0 0
0 0 0 0 0 0 0 0 0 0 0
0 0 0 0 0 0 0 0 0 0 0
0 0 0 0 0 0 0 0 0 0 0
0 0 0 0 0 0 0 0 0 0 0
0 0 0 0 0 0 0 0 0 0 0
0 0 0 0 0 0 0 0 0 0 0
