MISSIONTYPE 1
SIZE 11/30
LIMIT 0/28
COLOR LIMIT 3
STARS 3000/15000/30000
0 0 0 0 0 0 0 0 0 0 0
0 0 0 0 0 5 0 0 0 0 0
0 0 0 1 0 5 5 0 1 0 0
0 0 1 5 3 1 5 5 1 0 0
0 0 0 5 1 5 5 5 5 0 0
0 5 5 5 1 7 1 1 5 1 0
0 0 0 3 3 5 3 5 1 0 0
0 0 5 1 5 5 1 3 5 0 0
0 0 0 5 0 3 3 0 5 0 0
0 0 0 0 0 3 0 0 0 0 0
0 0 0 0 0 0 0 0 0 0 0
0 0 0 0 0 0 0 0 0 0 0
0 0 0 0 0 0 0 0 0 0 0
0 0 0 0 0 0 0 0 0 0 0
0 0 0 0 0 0 0 0 0 0 0
0 0 0 0 0 0 0 0 0 0 0
0 0 0 0 0 0 0 0 0 0 0
0 0 0 0 0 0 0 0 0 0 0
0 0 0 0 0 0 0 0 0 0 0
0 0 0 0 0 0 0 0 0 0 0
0 0 0 0 0 0 0 0 0 0 0
0 0 0 0 0 0 0 0 0 0 0
0 0 0 0 0 0 0 0 0 0 0
0 0 0 0 0 0 0 0 0 0 0
0 0 0 0 0 0 0 0 0 0 0
0 0 0 0 0 0 0 0 0 0 0
0 0 0 0 0 0 0 0 0 0 0
0 0 0 0 0 0 0 0 0 0 0
0 0 0 0 0 0 0 0 0 0 0
0 0 0 0 0 0 0 0 0 0 0
