MISSIONTYPE 0
SIZE 11/30
LIMIT 0/35
COLOR LIMIT 4
STARS 20000/65000/80000
FREE BOOST SCORE 65000
6 6 6 0 6 6 6 0 6 6 6
6 0 6 6 6 6 6 6 0 6 0
0 6 0 6 6 6 6 6 0 6 0
0 6 0 6 0 0 6 0 6 0 0
6 6 6 6 6 6 6 6 6 6 6
6 0 6 0 6 6 0 6 0 6 0
0 6 0 6 0 6 0 6 0 6 0
0 6 6 6 0 0 6 6 6 0 0
6 6 6 6 6 6 6 6 6 6 6
6 0 6 0 6 6 0 6 0 6 0
0 6 0 6 0 6 0 6 0 6 0
0 6 0 6 0 0 6 0 6 0 0
0 0 6 6 0 0 0 6 6 0 0
0 0 6 0 0 0 0 6 0 0 0
0 0 0 0 0 0 0 0 0 0 0
0 0 0 0 0 0 0 0 0 0 0
0 0 0 0 0 0 0 0 0 0 0
0 0 0 0 0 0 0 0 0 0 0
0 0 0 0 0 0 0 0 0 0 0
0 0 0 0 0 0 0 0 0 0 0
0 0 0 0 0 0 0 0 0 0 0
0 0 0 0 0 0 0 0 0 0 0
0 0 0 0 0 0 0 0 0 0 0
0 0 0 0 0 0 0 0 0 0 0
0 0 0 0 0 0 0 0 0 0 0
0 0 0 0 0 0 0 0 0 0 0
0 0 0 0 0 0 0 0 0 0 0
0 0 0 0 0 0 0 0 0 0 0
0 0 0 0 0 0 0 0 0 0 0
0 0 0 0 0 0 0 0 0 0 0
