MISSIONTYPE 0
SIZE 11/30
LIMIT 0/28
COLOR LIMIT 4
STARS 15000/30000/45000
FREE BOOST SCORE 30000
6 6 6 6 6 6 6 6 6 6 6
6 6 6 6,Smoke 6,Smoke 6,Smoke 6,Smoke 6 6 6 0
6 6 6 6 6 6 6 6 6 6 0
6 6 6 6 6 6 6 6 6 6 0
6 6 6 6 6 6 6,Smoke 6,Smoke 6,Smoke 6,Smoke 0
6 6 6 6 6 6 6 4 4 6 0
6 6,Smoke 6,Smoke 6,Smoke 6,Smoke 6 6 4 4 6 4
6 6 6 6 6 6 6 6 6 4 0
6 6 6 6 6 6 6 6,Smoke 6,Smoke 6,Smoke 4
5 6 6 0 0 0 0 0 0 4 0
5 6,Smoke 6,Smoke 0 0 0 0 0 0 0 0
5 0 0 0 0 0 0 0 0 0 0
0 0 0 0 0 0 0 0 0 0 0
0 0 0 0 0 0 0 0 0 0 0
0 0 0 0 0 0 0 0 0 0 0
0 0 0 0 0 0 0 0 0 0 0
0 0 0 0 0 0 0 0 0 0 0
0 0 0 0 0 0 0 0 0 0 0
0 0 0 0 0 0 0 0 0 0 0
0 0 0 0 0 0 0 0 0 0 0
0 0 0 0 0 0 0 0 0 0 0
0 0 0 0 0 0 0 0 0 0 0
0 0 0 0 0 0 0 0 0 0 0
0 0 0 0 0 0 0 0 0 0 0
0 0 0 0 0 0 0 0 0 0 0
0 0 0 0 0 0 0 0 0 0 0
0 0 0 0 0 0 0 0 0 0 0
0 0 0 0 0 0 0 0 0 0 0
0 0 0 0 0 0 0 0 0 0 0
0 0 0 0 0 0 0 0 0 0 0
