MISSIONTYPE 0
SIZE 11/30
LIMIT 0/29
COLOR LIMIT 4
STARS 3500/6800/9300
FREE BOOST SCORE 6800
6 6 6 6 6 6 6 6 6 6 6
6 6 0 0 6 6 0 0 6 6 0
0 6 6 0 0 6 0 0 6 6 0
0 6 6 0 6 6 0 6 6 0 0
0 0 6 6 0 6 0 6 6 0 0
0 0 6 6 6 6 6 6 0 0 0
0 0 0 6 6 6 6 6 0 0 0
0 0 0 6 6 6 6 0 0 0 0
0 0 0 0 6 6 6 0 0 0 0
6 6 6 6 6 6 6 6 6 6 0
0 6 6 6 6 6 6 6 6 6 0
0 6 6 0 0 0 0 6 6 0 0
0 0 6 6 0 0 0 6 6 0 0
0 0 6 6 6 6 6 6 0 0 0
0 0 6 6 0 0 0 6 6 0 0
0 6 6 0 0 0 0 6 6 0 0
0 6 6 6 6 6 6 6 6 6 0
6 6 0 0 0 0 0 0 6 6 0
0 6 6 0 0 0 0 0 6 6 0
0 6 6 6 6 6 6 6 6 0 0
0 0 6 6 6 6 6 6 6 0 0
0 6 6 0 0 0 0 6 6 0 0
0 6 6 0 0 0 0 0 6 6 0
6 6 6 6 6 6 6 6 6 6 0
0 6 6 6 6 6 6 6 6 6 0
0 6 6 0 0 0 0 6 6 0 0
0 0 6 6 0 0 0 6 6 0 0
0 0 6 6 6 6 6 6 0 0 0
0 0 0 6 6 6 6 6 0 0 0
0 0 0 0 0 0 0 0 0 0 0
