MISSIONTYPE 1
SIZE 11/30
LIMIT 0/25
COLOR LIMIT 2
STARS 5000/10000/20000
FREE BOOST SCORE 10000
0 0 0 0 0 0 0 0 0 0 0
0 0 0 3 3 1 3 1 0 0 0
0 0 0 1 3 0 0 3 1 0 0
0 0 1 0 1 0 3 0 3 0 0
0 0 1 0 0 1 1 0 0 3 0
0 1 3 1 1 7 1 1 3 3 0
0 0 1 0 0 3 3 0 0 3 0
0 0 3 0 3 0 3 0 1 0 0
0 0 0 1 1 0 0 1 3 0 0
0 0 0 3 1 3 3 1 0 0 0
0 0 0 0 0 0 0 0 0 0 0
0 0 0 0 0 0 0 0 0 0 0
0 0 0 0 0 0 0 0 0 0 0
0 0 0 0 0 0 0 0 0 0 0
0 0 0 0 0 0 0 0 0 0 0
0 0 0 0 0 0 0 0 0 0 0
0 0 0 0 0 0 0 0 0 0 0
0 0 0 0 0 0 0 0 0 0 0
0 0 0 0 0 0 0 0 0 0 0
0 0 0 0 0 0 0 0 0 0 0
0 0 0 0 0 0 0 0 0 0 0
0 0 0 0 0 0 0 0 0 0 0
0 0 0 0 0 0 0 0 0 0 0
0 0 0 0 0 0 0 0 0 0 0
0 0 0 0 0 0 0 0 0 0 0
0 0 0 0 0 0 0 0 0 0 0
0 0 0 0 0 0 0 0 0 0 0
0 0 0 0 0 0 0 0 0 0 0
0 0 0 0 0 0 0 0 0 0 0
0 0 0 0 0 0 0 0 0 0 0
