MISSIONTYPE 0
SIZE 11/30
LIMIT 0/22
COLOR LIMIT 3
STARS 5000/20000/350000
FREE BOOST SCORE 20000
6 6 6 6 6 6 6 6 6 6 6
5 5 5 5 3 1 3 5 5 1 0
0 5 5 5 5 3 3 5 5 3 0
0 5 1 3 5 3 1 3 5 0 0
0 0 1 3 5 3 1 5 1 0 0
0 0 3 5 1 3 1 5 0 0 0
0 0 0 3 3 1 3 1 0 0 0
0 0 0 5 1 1 3 0 0 0 0
0 0 0 0 1 1 6 0 0 0 0
0 0 0 0 1 6 0 0 0 0 0
0 0 0 0 0 6 0 0 0 0 0
0 0 0 0 0 0 0 0 0 0 0
0 0 0 0 0 0 0 0 0 0 0
0 0 0 0 0 0 0 0 0 0 0
0 0 0 0 0 0 0 0 0 0 0
0 0 0 0 0 0 0 0 0 0 0
0 0 0 0 0 0 0 0 0 0 0
0 0 0 0 0 0 0 0 0 0 0
0 0 0 0 0 0 0 0 0 0 0
0 0 0 0 0 0 0 0 0 0 0
0 0 0 0 0 0 0 0 0 0 0
0 0 0 0 0 0 0 0 0 0 0
0 0 0 0 0 0 0 0 0 0 0
0 0 0 0 0 0 0 0 0 0 0
0 0 0 0 0 0 0 0 0 0 0
0 0 0 0 0 0 0 0 0 0 0
0 0 0 0 0 0 0 0 0 0 0
0 0 0 0 0 0 0 0 0 0 0
0 0 0 0 0 0 0 0 0 0 0
0 0 0 0 0 0 0 0 0 0 0
